OOOOOOOOOOOOOOOOOOOOOOOOOOOOOOOOOOOOOOOOOOOOOO
OOOOWWWWWWWWWWWOOOOOOOOOOOOOOOOOOOOOOOOOOOOOOO
OOOOWOOOOOOOOOWOOOOOOOOOOOOOOOOOOOOOOOOOOOOOOO
OOOOWOOOlOOOOOWOOOOOOOOOOOOOOOOOOOOOOOOOOOOOOO
OOOOWOOOOOOOOOWOOOOOOOOOOOOOWWWWWWWWWWWOOOOOOO
OOOOWOMOMOOOOOWOOOOOOOOOOOOOWOOOOOOOOOWOOOOOOO
OOOOWWWDWWWWWWWOOOOOOOOOOOOOWOOOOOOOOOWOOOOOOO
OOOOOWOOOWOOOOOOOOOOOOOOOOOOWOOOOlOOOOWOOOOOOO
OOOOOWOlOWWWWWWWWWWWWWWWWWWWWOOMOOOOOOWOOOOOOO
OOOOOWOOOdOOOOOOOOOOOOOOOOOOWOOOOOOOOOWOOOOOOO
OOOOOWOOOWOOOOOMOOOOlOOOOOOOWWWWWDWWWWWOOOOOOO
OOOOOWWWWWOOOOOOOOOOOOOOOOOOOOOOOOOOOOWOOOOOOO
OOOOOOOOWWWWWWWWWOOOOOOOOOOOOOOOOMOOOOWOOOOOOO
OOOOOOOOWOOOOOOOWOOOOOOOOOOOOOOOOOOOOOWOOOOOOO
OOOOOOOOWOOlOOOOWWWWWWWWWWWWWWWWWDWWWWWWWWWOOO
OOOOOOOOWOOOOOOOOOlOOOOOOOOOlOOOOOOOOOOOOWOOOO
OOOOOOOOWWWWWWWWWWWWWWWWWWWWWWWOOOOOOOOOOWOOOO
OOOOOOOOOOOOOOOOOOOOOOOOOOOOOOdOOOOMOOOOOWOOOO
OOOOOOOOOOOOOOOOOOOOOOOOOOOOOOWOOOOOOOOOOWOOOO
OOOOOOOOOOOOOOOOOOOOOOOOOOOOOOWOOlOOOOlOOWOOOO
OOOOOOOOOOOOOOOOOOOOOOOOOOOOOOWWWWWWDWWWWWOOOO
OOOOOOOOOOOOOOOOOOWWWWWOOOOOOOOOOWOOOOWOOOOOOO
OOOOOOOOOOOOOOOOOOWOOOWOOOOOOOOOOWOlOOWOOOOOOO
OOOOOOOOOOOOOOOOOOWOlOWOOOOOOOOOOWOOOOWOOOOOOO
OOOOOOOOOOOOOOOOOOWOOOWOOOOOOOOOOWOOOOWOOOOOOO
OOOOOOOOOOOOOOOOOOWOMOWOOOOOOOOOOWOOOOWOOOOOOO
OOOOOOOOOOOOOWWWWWWWDWWWWWWWWWWWWWOlOOWOOOOOOO
OOOOOOOOOOOOOWOOOOOOOOOOOOOOOOOOOWOOOOWOOOOOOO
OOOOOOOOOOOOOWOOOOOOOOlOOOOOOOOOOdOOOOWOOOOOOO
OOOOOOOOOOOOOWOOOOMOOOOOOMOOOOOOOWOOOOWOOOOOOO
OOOOOOOOOOOOOWOOOOOOOOlOOOOOOOOOOWOOOOWOOOOOOO
OOOOOOOOOOOOOWWWWWWWWWWWWWWWWWWWWWOOOOWOOOOOOO
OOOOOOOOOOOOOOOOOOOOOOOOOOOOOOOOOWOOOOWOOOOOOO
OOOOOOOOOOOOOOOOOOOOOOOOOOOOOOOOOWOOlOWOOOOOOO
OOOOOOOOOOOOOOOOOOOOOOOOOOOOOOOOOWOOOOWOOOOOOO
OOOOOOOOOOOOOOOOOOOOOOOOOOOOOOOOOWOOOOWOOOOOOO
OOOOOOOOOOOOOOOOOOOOOOOOOOOOOOOOOWOOOOWOOOOOOO
OOOOOOOOOOOOOOOOOWWWWWWWWWWWWWWWWWOOOOWWWWWWOO
OOOOOOOOOOOOOOOOOWOOOOOOOOOOOOOOOOOOOOOOOOOWOO
OOOOOOOOOOOOOOOOOWOOOOOOOOOOOOOOOOOOOOOOOOOWOO
OOOOOOOOOOOOOOOOOWOOOOlOOOOOOOOMOOOOOOlOOOOWOO
OOOOOOOOOOOOOOOOOWOOOOOOOOOOOOOOOOOOOOOOOOOWOO
OOOOOOOOOOOOOOOOOWOOOOOOOOOOOOOOOOOOOOOOOOOWOO
OOOOOOOOOOOOOOOOOWWWWWWWWWWWWWWWWWWWWWWWWWWWOO
OOOOOOOOOOOOOOOOOOOOOOOOOOOOOOOOOOOOOOOOOOOOOO
OOOOOOOOOOOOOOOOOOOOOOOOOOOOOOOOOOOOOOOOOOOOOO
OOOOOOOOOOOOOOOOOOOOOOOOOOOOOOOOOOOOOOOOOOOOOO
OOOOOOOOOOOOOOOOOOOOOOOOOOOOOOOOOOOOOOOOOOOOOO
OOOOOOOOOOOOOOOOOOOOOOOOOOOOOOOOOOOOOOOOOOOOOO